E--------E------------------------------------------------------
-E------E-----------------------------------------EEE---EEE-----
--E----E------E-------EEEE---E-----E--EEEEEE-----E---E-E----E---
---E--E-------E------E----E--E-----E--E---------E-----E------E--
----EE--------E------E----E---E---E---EEE--------E----------E---
----EE--------E------E----E----E-E----EEE---------E--------E----
---E--E-------E------E----E----E-E----E------------E------E-----
--E----E------EEEEE---EEEE------E-----EEEEEE--------E----E------
-E------E--------------------------------------------E--E-------
E--------E--------------------------------------------EE--------
