E--B--B--E------B--B------E--B------B--E------B------E--B------B--
-B--E--E--B----B--E--B---B--E--B---B--E--B--B--E--B--E--B--E--B---
--E--B--B--E--E--B--B--E--B--B--E--B--B--E--E--B--B--B--B--B--E---
---B--E--E--B--B--E--E---B--E--B--E--B--B--E--B--E--B--E--B--E----
----E--B--B--E--E--B--B--E--B--B--B--E--E--B--E--B--E--B--E--B----
-----B--E--E--B--B--E--E--B--E--E--E--B--B--E--B--E--B--E--B------
------E--B--B--E--E--B--B--E--B--B--E--E--B--E--B--E--B--E--------
-------B--E--E--B--B--E--E--B--E--B--B--E--B--E--B--E--B----------
--------E--B--B--E--B--B--E--B--B--E--B--B--E--B--E--B------------
---------B--E--E--B--E--E--B--E--E--B--E--E--B--E--E--------------
